##################################################
#S.....#....#..............#..#......#..#....#...#
#.#.###.#.#######.#.#.######.#.######.#.##.#.#.#.#
#.#.#.....#.....#.#.#.#......#.#....#.#..#.#.#.#.#
#.#.#.#####.###.#.#.#.#.######.#.##.#.#.##.#.#.#.#
#.#.#.#...#.....#.#.#.#........#..#.#.#.#..#.#.#.#
#.#.#.#.#.#####.#.#.#.##########.##.#.#.#.##.#.#.#
#.#.#.#.#.....#.#.#.#..........#....#.#.#...#.#.#.
#.#.#.#.#####.#.#.#.##########.#.##.#.#.#####.#.#.
#.#.#.#.#...#.#.#.#..........#.#..#.#.#.#...#.#.#.
#.#.#.#.#.#.#.#.#.##########.#.##.#.#.#.#.#.#.#.#.
#.#.#.#.#.#...#.#..........#.#..#.#.#.#.#.#.#.#.#.
#.#.#.#.#######.##########.#.##.#.#.#.#.#.#.#.#.#.
#.#.#.#.#.....#..........#.#..#.#.#.#.#.#.#.#.#.#.
#.#.#.#.#.###.##########.#.##.#.#.#.#.#.#.#.#.#.#.
#.#.#.#.#.#.#.#........#.#..#.#.#.#.#.#.#.#.#.#.#.
#.#.#.#.#.#.#.########.#.##.#.#.#.#.#.#.#.#.#.#.#.
#.#.#.#.#.#.#........#.#..#.#.#.#.#.#.#.#.#.#.#.#.
#.#.#.#.#.#.########.#.##.#.#.#.#.#.#.#.#.#.#.#.#.
#.#.#.#.#.#........#.#..#.#.#.#.#.#.#.#.#.#.#.#.#.
#.#.#.#.#.########.#.##.#.#.#.#.#.#.#.#.#.#.#.#.#.
#.#.#.#.#........#.#..#.#.#.#.#.#.#.#.#.#.#.#.#.#.
#.#.#.#.########.#.##.#.#.#.#.#.#.#.#.#.#.#.#.#.#.
#.#.#.#........#.#..#.#.#.#.#.#.#.#.#.#.#.#.#.#.#.
#.#.#.########.#.##.#.#.#.#.#.#.#.#.#.#.#.#.#.#.#.
#.#.#........#.#..#.#.#.#.#.#.#.#.#.#.#.#.#.#.#.#.
#.#.########.#.##.#.#.#.#.#.#.#.#.#.#.#.#.#.#.#.#.
#.#........#.#..#.#.#.#.#.#.#.#.#.#.#.#.#.#.#.#.#.
#.########.#.##.#.#.#.#.#.#.#.#.#.#.#.#.#.#.#.#.#.
#........#.#..#.#.#.#.#.#.#.#.#.#.#.#.#.#.#.#.#.#.
########.#.##.#.#.#.#.#.#.#.#.#.#.#.#.#.#.#.#.#.#.
#........#....#.#.#.#.#.#.#.#.#.#.#.#.#.#.#.#.#.#.
########.###.#.#.#.#.#.#.#.#.#.#.#.#.#.#.#.#.#.#.#
#......#.....#.#.#.#.#.#.#.#.#.#.#.#.#.#.#.#.#.#.#
######.#####.#.#.#.#.#.#.#.#.#.#.#.#.#.#.#.#.#.#.#
#....#.....#.#.#.#.#.#.#.#.#.#.#.#.#.#.#.#.#.#.#.#
#.#.#####.#.#.#.#.#.#.#.#.#.#.#.#.#.#.#.#.#.#.#.#E
#.#.#.....#.#.#.#.#.#.#.#.#.#.#.#.#.#.#.#.#.#.#.#.
#.#.#.#####.#.#.#.#.#.#.#.#.#.#.#.#.#.#.#.#.#.#.#.
#.#.#.#.....#.#.#.#.#.#.#.#.#.#.#.#.#.#.#.#.#.#.#.
#.#.#.#.#####.#.#.#.#.#.#.#.#.#.#.#.#.#.#.#.#.#.#.
#.#.#.#.......#.#.#.#.#.#.#.#.#.#.#.#.#.#.#.#.#.#.
#.#.###########.#.#.#.#.#.#.#.#.#.#.#.#.#.#.#.#.#.
#.#.............#.#.#.#.#.#.#.#.#.#.#.#.#.#.#.#.#.
#.###############.#.#.#.#.#.#.#.#.#.#.#.#.#.#.#.#.
#.#...............#.#.#.#.#.......................
..................................................