#########...#
#S#.#......##
#.#...#.#..##
#.#.###.#..##
#.#...#.#..##
#.#.#...#..##
#.#.#..##..##
#...##..#..##
#######E...##
#########..##
