E........
.###.###.
.###.###.
....S....
.###.###.
.###.###.
.........