#########
#S#.#...#
#.#.#.#.#
#.#...#.#
#.##.##.#
#.....#.#
#.###.#.#
#.....#.#
#######E#
#########
