####################################################################################################
#S#................................................................................................#
#.#.#####.#####.####################################################################################
#..................................................................................................#
#.##.###.#.###.#.###################################################################################
#..................................................................................................#
#.###.#.###.#.###.##################################################################################
#..................................................................................................#
#.####.#####.#####.#################################################################################
#.................................................................................................E#
####################################################################################################