#########
#S#...#.#
#.#.#.#.#
#.#.#.#.#
#.#.#...#
#...#.#.#
#.#.#.#.#
#.#.#.#.#
#...#..E#
#########
