####################################################################################################
#S#................................................................................................#
#.#.################################################################################################
#.#................................................................................................#
#.##################################################################################################
#..................................................................................................#
#.##################################################################################################
#..................................................................................................#
#.##################################################################################################
#..................................................................................................#
#.##################################################################################################
#..................................................................................................#
#.##################################################################################################
#..................................................................................................#
#.##################################################################################################
#..................................................................................................#
#.##################################################################################################
#..................................................................................................#
#.##################################################################################################
#..................................................................................................#
#.##################################################################################################
#..................................................................................................#
#.##################################################################################################
#..................................................................................................#
#.##################################################################################################
#..................................................................................................#
#.##################################################################################################
#..................................................................................................#
#.##################################################################################################
#..................................................................................................#
#.##################################################################################################
#..................................................................................................#
#.##################################################################################################
#..................................................................................................#
#.##################################################################################################
#..................................................................................................#
#.##################################################################################################
#..................................................................................................#
#.##################################################################################################
#..................................................................................................#
#.##################################################################################################
#..................................................................................................#
#.##################################################################################################
#..................................................................................................#
#.##################################################################################################
#..................................................................................................#
#.##################################################################################################
#..................................................................................................#
#.##################################################################################################
#..................................................................................................#
#.##################################################################################################
#..................................................................................................#
#.##################################################################################################
#..................................................................................................#
#.##################################################################################################
#..................................................................................................#
#.##################################################################################################
#..................................................................................................#
#.##################################################################################################
#..................................................................................................#
#.##################################################################################################
#..................................................................................................#
#.##################################################################################################
#..................................................................................................#
#.##################################################################################################
#..................................................................................................#
#.##################################################################################################
#..................................................................................................#
#.##################################################################################################
#..................................................................................................#
#.##################################################################################################
#..................................................................................................#
#.##################################################################################################
#..................................................................................................#
#.##################################################################################################
#..................................................................................................#
#.##################################################################################################
#..................................................................................................#
#.##################################################################################################
#..................................................................................................#
#.##################################################################################################
#..................................................................................................#
#.##################################################################################################
#..................................................................................................#
#.##################################################################################################
#..................................................................................................#
#.##################################################################################################
#..................................................................................................#
#.##################################################################################################
#..................................................................................................#
#.##################################################################################################
#..................................................................................................#
#.##################################################################################################
#..................................................................................................#
#.##################################################################################################
#..................................................................................................#
#.##################################################################################################
#..................................................................................................#
#.................................................................................................E#
####################################################################################################
