#########
#S#...#.#
#.#.#.#.#
#.##.#..#
#.#...#.#
#.#.....#
#.##.#.##
#....#..#
##.##..E#
##....###
